P-------
PLL-----
P-P-----
P-PE----
P-PLL---
----P---
----P---
P---P---
P-PE----
P-PE----
P-------
P-------
P-------
PE------
PE------
P-------
P-------
P-------
PLL-----
P-P-----
P-P-----
P-P-----
P-PLLLL-
P-----P-
P-----PE
P-----P-
P-----PE
P-----PE
-----LL-
P----P--
P----PE-
P----PE-
----LL--
P---P---
P---PE--
P---PE--
P---P---
PLLL----
P-------
PE------
PE------
PE------