P-------
PLL-----
P-P-----
P-PE----
PLL-----
P-------
P-------
P-------
P-------
P-------
P-------
P-------
P-------
P-------
P-------
P-------
